111111111111111111111111111111111111111111111111111111111111111111111
111111111111111111111111111111111111111111111111111111111111111111111
111111111111111111111111111111111W11111111111111111111111111111111111
111111111111111111111111111111111W11111111111111111111111111111111111
111111111111111111111111111111111W11111111111111111111111111111111111
111111111111111111111111111111111D11111111111111111111111111111111111
111111111111111111111111111111111D11111111111111111111111111111111111
111111111111111111111111111111111D11111111111111111111111111111111111
111000000000000C11111000000000000011111011111000000000000000000C11111
111011111111111011111011111111111111111011111011111111111011111011111
111011111111111011111011111111111111111011111011111111111011111011111
111011111111111011111011111111111111111011111011111111111011111011111
111011111111111011111011111111111111111011111011111111111011111011111
111011111111111011111011111111111111111011111011111111111011111011111
111000000011111000000011111000000011111C00000011111000000011111011111
111111111011111111111111111111111011111111111111111011111111111011111
111111111011111111111111111111111011111111111111111011111111111011111
111111111011111111111111111111111011111111111111111011111111111011111
111111111011111111111111111111111011111111111111111011111111111011111
111111111011111111111111111111111011111111111111111011111111111011111
111C11111011111000000000000011111000000000000000000011111000000011111
111011111011111011111111111011111011111111111111111111111111111011111
111011111011111011111111111011111011111111111111111111111111111011111
111011111011111011111111111011111011111111111111111111111111111011111
111011111011111011111111111011111011111111111111111111111111111011111
111011111011111011111111111011111011111111111111111111111111111011111
111011111011111011111011111000000011111000000C00000011111000000011111
111011111011111011111011111111111111111011111011111011111011111111111
111011111011111011111011111111111111111011111011111011111011111111111
111011111011111011111011111111111111111011111011111011111011111111111
111011111011111011111011111111111111111011111011111011111011111111111
111011111011111011111011111111111111111011111011111011111011111111111
111011111000000011111000000000000000000011111011111011111000000011111
111011111011111111111111111011111111111111111011111011111111111011111
111011111011111111111111111011111111111111111011111011111111111011111
111011111011111111111111111011111111111111111011111011111111111011111
111011111011111111111111111011111111111111111011111011111111111011111
111011111011111111111111111011111111111111111011111011111111111011111
111000000011111011111000000011111000000011111011111011111C00000011111
111011111111111011111011111111111111111011111011111011111111111011111
111011111111111011111011111111111111111011111011111011111111111011111
111011111111111011111011111111111111111011111011111011111111111011111
111011111111111011111011111111111111111011111011111011111111111011111
111011111111111011111011111111111111111011111011111011111111111011111
111000000011111011111000000000000011111011111011111000000000000011111
111111111011111011111011111111111011111011111011111011111111111111111
111111111011111011111011111111111011111011111011111011111111111111111
111111111011111011111011111111111011111011111011111011111111111111111
111111111011111011111011111111111011111011111011111011111111111111111
111111111011111011111011111111111011111011111011111011111111111111111
111C00000011111011111000000C11111011111000000011111000000000000011111
111011111111111011111111111011111011111111111111111111111011111011111
111011111111111011111111111011111011111111111111111111111011111011111
111011111111111011111111111011111011111111111111111111111011111011111
111011111111111011111111111011111011111111111111111111111011111011111
111011111111111011111111111011111011111111111111111111111011111011111
111000000011111011111000000011111011111000000000000000000C11111011111
111011111011111011111011111011111011111111111011111111111111111011111
111011111011111011111011111011111011111111111011111111111111111011111
111011111011111011111011111011111011111111111011111111111111111011111
111011111011111011111011111011111011111111111011111111111111111011111
111011111011111011111011111011111011111111111011111111111111111011111
111011111000000011111011111011111011111000000011111000000000000011111
111011111111111011111111111011111011111011111111111111111111111011111
111011111111111011111111111011111011111011111111111111111111111011111
111011111111111011111111111011111111111011111111111111111111111011111
111011111111111011111111111011111111111011111111111111111111111011111
111011111111111011111111111011111111111011111111111111111111111011111
111C00000011111000000000000000000000000011111000000000000000000011111
111111111111111111111111111111111011111111111111111111111111111111111
111111111111111111111111111111111P11111111111111111111111111111111111
111111111111111111111111111111111111111111111111111111111111111111111